..E.............
..............E.
E...............
......E......E..
................
...E.WWWWW......
.....W...W.E....
.....W.P.W......
..E..W...W......
.....WWWWW..E...
....E...........
........W......E
.......WWW......
......WWWWW.....
E....WWWCWWW....