.......E
..E.....
....W...
.......E
.W..P..W
........
....W...
C.......