.E.......E......
W.W..WWW.W.W.WWW
W.W..W.W.W.W.W..
W.W..W.W.W.W.WWW
W.W..W.W..W..W..
W.WW.WWW..W..WWW
................
WW....W..WWW..W.
W.W..W.W..W..W.W
W.W..W.W..W..WWW
WW....W...W..W.W
................
................
.......WWW......
......PWCW......