E......E..
..E.......
....W....E
.......E..
.W..P..W..
..........
....W.....
C.........
..........
..........