........
........
....W...
........
.W..P..W
........
....W...
C.......