..E.............
........WWW.E...
....WWW....WWW..
.WWW............
......WWW.......
....WW...WWW...E
..WWW..E.WWW..WW
....WW...WW.....
......W.W.......
..E....W........
....WWW.........
.WWW............
W...............
.......WWW......
......PWCW......