..E.............
..............E.
E...............
......E......E..
................
...E............
...........E....
................
..E.............
..........E.....
....E...........
...............E
................
.......WWW......
E.....PWCW......