..E.............
..............E.
E...............
......E.........
................
................
...........E....
................
..E.............
................
................
................
................
.......WWW......
......PWCW......