W.........
..........
.........W
..........
W.........
.........W
..........
..T.......
..........
.........W