..........
..........
W.........
.........W
..........
..........
..T.P.T..W
..........
.........W