W...T.....
..........
.........W
..........
W.........
.........W
..........
..........
..........
.........W