..........
..........
W.........
.........W
..........
..........
..T.T.T..W
..........
.........W